5 7
@ @ @ @ @ @ @
@ @ @ @ @ . @
@ . . . . . @
@ @ @ @ @ . @
@ @ @ @ @ @ @
2
2 2 2 4
2 1 1 5